[
    {
        "s": [3, 7],
        "k": [
            [15, 12]
        ],
        "b": [
            [12, 7]
        ],
        "m": [
            [3,3,3,3,3,3,3,3,3,3,3,3,3,3,3,3,3,3,3],
            [3,4,3,1,1,1,1,1,1,1,1,1,1,3,10,10,10,10,3],
            [3,1,1,1,1,1,3,3,3,1,1,1,1,8,9,9,9,10,3],
            [3,3,3,3,1,1,3,11,3,1,1,1,1,10,10,10,9,9,3],
            [3,1,1,1,1,1,1,1,1,1,1,1,1,3,9,9,9,10,3],
            [3,1,3,1,1,1,1,1,1,1,1,1,1,3,9,10,10,10,3],
            [3,1,3,3,3,1,1,1,1,1,1,1,1,3,9,10,10,10,3],
            [3,6,3,1,1,1,1,1,1,1,5,1,1,3,9,9,9,9,3],
            [3,1,3,3,3,1,1,1,1,1,2,1,1,3,9,10,10,9,3],
            [3,1,3,2,2,1,1,1,1,3,1,3,1,3,10,9,9,9,3],
            [3,2,1,2,1,3,1,1,1,3,1,1,1,3,3,10,9,10,3],
            [3,1,3,1,3,3,1,5,1,3,1,1,1,1,3,3,8,9,3],
            [3,1,1,2,1,3,1,1,1,3,1,1,1,2,2,1,3,9,3],
            [3,1,1,1,1,3,3,3,3,3,1,1,3,3,3,3,3,7,3],
            [3,3,3,3,3,3,3,3,3,3,3,3,3,3,3,3,3,3,3]
        ],
        "a": [
            {
                "o": [3, 9],
                "m": [
                    [1, 2],
                    [2, 2]
                ]
            }
        ]
    }
]